11111111111
1P000000001
10000000001
10011111001
10000C00001
10000000001
10001010001
101C101C101
10101C10101
10001010001
10000000001
10000C00001
10011111001
10000000001
100000000E1
11111111111