111111111111111111
1P0000000000000001
101010001111110101
100010001000010101
101110001111010101
101010000001010101
101011111101010101
101010000001010101
101010000000010101
101011111110010101
1000000000000000S1
111111111111111111