11111111111111
1P000000000001
10000000000001
10011111111001
10010000001001
10010C00C01001
10010000001001
10000000000001
10000111100001
111000CC000111
10000111100001
10000000000001
10010000001001
10010C00C01001
10010000001001
10011111111001
10000000000111
100000000001E1
11111111111111