111111111111111111
10000000C000000001
101010001111110101
100010001C000101C1
101110001111010101
101C10000001010101
101011111101010101
101010000001010101
1C101C000000010101
101011111110010101
100000C000000000S1
111111111111111111